10,10
4
#LEGEND
01=true
02=true
04=true
#END LEGEND
03,03,03,03,03,03,03,03,03,03
02,02,02,02,02,02,02,02,02,02
01,01,01,01,01,01,01,01,01,01
01,01,01,01,01,01,01,01,01,01
01,01,01,01,01,01,01,01,01,01
01,01,01,01,01,01,01,01,01,01
01,01,01,01,01,01,01,01,01,01
01,01,01,01,01,01,01,01,01,01
01,01,01,01,01,01,01,01,01,01
01,01,01,01,04,04,01,01,01,01
