#START TILE
1=2
2=1
3=0
4=0
5=0
6=0
7=0
8=3	
9=0
10=0
11=0
#END TILE
#START OPTION
SLEEP=10
#END OPTION
5,5,5,5,5,5,5,5,5,5,5,5,5,5,5,5,5,5,5,5
5,1,1,1,1,1,1,1,1,1,1,1,1,1,1,1,1,1,1,5
5,1i,2,2,2,9,1,1,2,2,2,9,1,1,2,2,2,9,1,5
5,1,2,2,2,1,1,1,2,2,2,1,1,1,2,2,2,1,1,5
5,1,2,2,2,1,1,1,2,2,2,1,1,1,2,2,2,1,1,5
5,1,1,1,1,1,1,1,1,1,1,1,1,1,1,1,1,1,1,5
5,1,1,1,1,1,1,1,8,8,8,1,1,1,1,1,1,1,1,5
5,3,3,3,3,3,3,3,3,8,3,3,3,3,3,3,3,3,3,5
5,1,1,1,1,1,1,1,1,8,1,1,1,1,1,1,1,1,1,5
5,1,1,2,2,2,9,1,1,8,2,2,2,9,1,1,1,1,1,5
5,1,1,2,2,2,1,1,1,8,2,2,2,1,1,1,1,1,1,5
5,1,1,2,2,2,1,1,1,8,2,2,2,1,1,1,1,1,1,5
5,1,1,1,1,1,1,1,1,8,1,1,1,1,1,1,1,1,1,5
5,3,3,3,3,3,3,3,3,8,3,3,3,3,3,3,3,3,3,5
5,1,1,1,1,1,1,1,1,8,1,1,1,1,1,1,1,1,1,5
5,1,1,2,2,2,9,1,1,8,2,2,2,9,1,1,1,1,1,5
5,1,1,2,2,2,1,1,1,8,2,2,2,1,1,1,1,1,1,5
5,1,1,2,2,2,1,1,1,8,2,2,2,1,1,1,1,1,1,5
5,1,1,1,1,1,1,1,1,8,1,1,1,1,1,1,1,1,1,5
5,1,1,2,2,2,9,1,1,8,2,2,2,9,1,1,1,1,1,5
5,1,1,2,2,2,1,1,1,8,2,2,2,1,1,1,1,1,1,5
5,1,1,2,2,2,1,1,1,8,2,2,2,1,1,1,1,1,1,5
5,1,1,1,1,1,1,1,7,8,7,1,1,1,1,1,1,1,1,5
5,5,5,5,5,5,5,5,5,8,5,5,5,5,5,5,5,5,5,5