40,30
16
#LEGEND
01=true
05=true
06=true
07=true
08=true
#END LEGEND
03,03,09,05,08,01,01,02,02,02,01,01,01,01,01,01,01,01,01,01,08,08,07,07,07,01,01,01,01,01,01,01,06,08,08,08,08,08,08,08
03,03,14,05,08,01,01,02,02,02,02,01,01,01,01,01,01,01,01,01,08,08,07,07,07,01,01,01,01,01,01,01,06,08,08,05,05,05,05,05
10,14,05,05,08,01,01,02,02,02,02,02,01,01,01,01,01,01,01,01,08,08,07,07,07,01,01,01,01,08,08,01,06,05,05,05,05,05,05,05
05,05,05,08,08,01,01,02,02,02,02,02,02,01,01,01,01,01,01,01,08,08,07,07,07,01,01,01,08,08,08,08,06,05,05,05,05,12,11,11
08,08,08,08,01,01,01,02,02,02,02,02,02,02,01,01,01,01,01,08,08,08,07,07,07,01,01,01,08,01,08,06,06,05,05,05,12,03,03,03
01,01,01,01,01,01,01,02,02,02,02,02,02,02,02,02,01,01,08,08,08,08,07,07,07,08,08,08,08,01,08,06,05,05,05,12,03,03,03,03
01,01,01,01,01,01,01,02,02,02,02,02,02,02,02,02,02,01,08,08,08,08,07,07,07,08,01,01,01,01,08,06,05,05,05,04,03,03,03,03
01,01,01,01,01,01,01,02,02,02,02,02,02,02,02,02,02,02,08,08,08,08,07,07,07,08,08,01,01,01,01,06,05,05,05,04,03,03,03,03
01,01,01,01,01,01,01,02,02,02,02,02,02,02,02,02,02,02,08,08,08,08,07,07,07,08,08,08,08,08,01,06,05,05,05,04,03,03,03,03
01,01,01,01,01,01,01,02,02,02,02,02,02,02,02,02,02,02,02,08,08,08,07,07,07,08,08,01,08,01,01,06,05,05,05,04,03,03,03,03
01,01,01,01,01,02,02,02,02,02,02,02,02,02,02,02,02,02,02,08,08,08,07,07,07,08,08,01,01,01,01,06,05,05,05,04,03,03,03,03
01,01,01,01,01,02,02,02,02,02,02,02,02,02,02,02,02,02,02,08,08,08,07,07,07,08,08,01,01,01,06,06,05,05,05,04,03,03,03,03
01,01,01,01,01,02,02,02,02,02,02,02,02,02,02,02,02,02,02,02,08,08,07,07,07,08,01,01,01,01,06,05,05,05,05,04,03,03,03,03
01,01,01,01,01,02,02,02,02,02,02,02,02,02,02,02,02,02,08,08,08,08,07,07,07,08,08,01,01,01,06,05,05,05,05,04,03,03,03,03
01,01,01,01,01,02,02,02,02,02,02,02,02,02,02,02,02,02,08,08,08,08,07,07,07,08,01,01,01,01,06,05,05,05,05,04,03,03,03,03
01,01,01,01,01,02,02,02,02,02,02,02,02,02,02,02,02,02,02,08,08,08,07,07,07,08,01,01,01,01,06,05,05,05,05,04,03,03,03,03
01,01,01,01,01,02,02,02,02,08,02,08,08,02,02,02,02,02,02,02,08,08,07,07,07,08,08,08,08,06,06,05,05,05,05,04,03,03,03,03
01,01,01,01,01,02,02,02,08,08,08,08,08,02,02,08,08,07,07,07,07,07,07,07,07,08,08,08,08,06,05,05,05,12,11,03,03,03,03,03
01,01,01,01,01,01,01,01,01,08,08,08,08,08,08,08,08,07,07,07,07,07,07,07,07,06,06,06,06,06,05,05,05,04,03,03,03,03,03,03
01,01,01,01,01,01,01,01,01,01,01,08,08,08,08,08,08,07,07,07,07,07,07,07,07,08,08,08,08,08,05,05,05,04,03,03,03,03,03,03
01,01,01,01,01,01,01,01,01,08,08,08,08,08,08,08,08,07,07,07,08,08,08,08,08,08,01,01,08,08,05,05,05,13,03,03,03,03,03,03
01,01,01,01,01,01,01,01,01,08,08,08,08,08,08,08,08,07,07,07,08,08,08,08,08,01,01,01,01,08,05,05,05,05,13,03,03,03,03,03
01,01,01,01,01,01,01,01,01,08,08,08,08,08,08,08,08,07,07,07,08,08,01,08,01,01,01,01,08,08,05,05,05,05,05,04,03,03,03,03
01,01,01,01,01,01,01,01,01,08,08,08,08,08,08,08,08,07,07,07,08,08,01,01,08,08,08,08,08,08,08,05,05,05,05,04,03,03,03,03
01,01,01,01,01,01,01,01,01,01,08,08,08,08,08,08,16,07,07,07,08,08,01,01,01,01,01,01,01,08,08,05,05,05,05,04,03,03,03,03
01,01,01,01,01,01,01,01,01,01,08,08,08,08,08,08,08,07,07,07,08,08,01,01,01,01,01,01,01,01,08,08,05,05,05,13,03,03,03,03
01,01,01,01,01,01,01,01,01,08,08,08,08,08,08,08,08,07,07,07,08,08,01,01,01,01,08,01,01,01,08,08,05,05,05,05,13,03,03,03
01,01,01,01,01,01,01,08,08,08,08,08,08,08,08,08,16,07,07,07,08,08,08,08,08,08,01,08,01,01,08,08,08,05,05,05,05,13,10,10
01,01,01,01,01,08,08,08,08,08,08,08,08,08,08,08,08,07,07,07,08,08,01,01,01,01,01,01,01,01,08,08,08,08,05,05,05,05,05,05
01,01,01,01,01,08,08,08,08,08,08,08,08,08,08,08,08,07,07,07,08,08,08,08,08,08,08,08,08,08,08,08,08,08,08,05,05,05,05,05